安装Linux系统时 可以值分swap分区（可以和内存同等大小） 和 根目录/ 其他不要

/bin	可执行文件 即命令
/boot	引导目录 系统的引导启动 boot/greb 引导程序
/dev	保存所用的硬件设备，将设备抽象为文件
/etc	包含了几乎所有的配置文件
/home	每一个用户在home中对应的文件夹，所有用户的私有问件 类似于windows的我的文档
/lib	所有相关的库文件
/media	挂载目录
/mnt	挂载目录 如U盘 挂载
/opt 	通常用来装大型软件
/proc	显示系统的实时的信息 保存在内存中的虚拟数据
/root 	root用户的home目录
/sbin	只有root用户才能执行的命令
/sys	系统底层硬件的信息
/tmp	临时目录 系统每隔一段时间自动删除
/usr	应用软件默认装在这里
/var 	保存经常变化的东西 如：系统的日志信息

磁盘的使用：	分区
		创建文件系统  ext3 ext4(linux)
		挂载到一个目录上之后才能使用

